1111111111111
10110F0000C01
1000011110001
1P0011E0000E1
1111111111111