1111111111111
1001000000001
1000011110001
10C011P0000E1
111111 111111