1111111111111
1001000000C01
1000011111001
1P0011E000001
11111111111111