1111111111111
1001000000001
1000011110001
1P0011E0000E1
1111111111111