1111111111111
1001000000C01
1000011110001
1P0011E0000E1
11111111111111111