11111111111111111111111111111111111111111111111
1000E000000000010000CC00000000000C0000000C01111
10000000000000010000CC00000000000C0000000C01111
10000000000000010000CC00000000000C0000000C01111
10000000000000010000CC00000000000C0000000C01111
10000000000000010000CC00000000000C0000P00C01111
10000000000000010000CC00000000000C0000000C01111
10000000000000010000CC00000000000C0000000C01111
11111111111111111111111111111111111111111111111