1111111111111
1001000000001
1000011110001
10C011E0000E1
1111111111111