1111111111111
1011000000C01
1000011110001
1P0011E0000E1
1111111111111