1111111111111
1001000000C01
1001011110001
1P0001E0000E1
1111111111111